Colesterol|a
Escuadra|b
Relatividad|c
Monologo|d
Fotocopia|e
Vecindario|f
Significado|g
Mandibula|h
Documento|i
Fregadero|j
Panorama|k
Pantano|l
Araña|m
Vegetal|n
Ladrillos|o
Apellido|p
Marisco|q
Fotografia|r
Oceano|s
Escuela|t
Bocina|u
Oso|v
Parilla|w
Hormona|x
Agitado|y
Despegue|z
Exterior|aa
Triste|ab
Escenografia|ac
Carambola|ad
Parquimetro|ae
Escarbar|af
Orangutan|ag
Ceramica|ah
Relampago|ai
Cancha|aj
Invierno|ak
Rehen|al
Celebridad|am
Veredicto|an